age_group,fatal-f,fatal-m,fatal-gd,fatal-u,fatal-total,fatal%
80s,1606,1601,0,20,3227,0.34
90+,1617,857,0,18,2492,0.26
70s,767,1200,0,6,1973,0.21
60s,372,733,0,8,1113,0.12
50s,166,311,0,2,479,0.05
40s,50,98,0,2,150,0.02
30s,16,42,0,4,62,0.01
20s,7,20,0,1,28,0.0
<20,3,2,0,0,5,0.0
UNKNOWN,0,0,0,1,1,0.0
