age_group,fatal-f,fatal-m,fatal-gd,fatal-u,fatal-total,fatal%
80s,1635,1626,0,20,3281,0.34
90+,1629,864,0,19,2512,0.26
70s,790,1226,0,6,2022,0.21
60s,384,751,0,8,1143,0.12
50s,172,325,0,2,499,0.05
40s,54,108,0,2,164,0.02
30s,20,42,0,5,67,0.01
20s,7,20,0,1,28,0.0
<20,4,2,0,0,6,0.0
UNKNOWN,0,0,0,1,1,0.0
