age_group,fatal-f,fatal-m,fatal-gd,fatal-u,fatal-total,fatal%
80s,1655,1662,0,18,3335,0.34
90+,1642,884,0,16,2542,0.26
70s,818,1257,0,5,2080,0.21
60s,399,779,0,6,1184,0.12
50s,182,340,0,1,523,0.05
40s,57,112,0,2,171,0.02
30s,24,46,0,5,75,0.01
20s,8,23,0,1,32,0.0
<20,4,3,0,0,7,0.0
UNKNOWN,0,0,0,1,1,0.0
