age_group,fatal-f,fatal-m,fatal-gd,fatal-u,fatal-total,fatal%
80s,1640,1632,0,20,3292,0.34
90+,1631,866,0,19,2516,0.26
70s,791,1230,0,6,2027,0.21
60s,387,754,0,8,1149,0.12
50s,175,328,0,2,505,0.05
40s,54,108,0,2,164,0.02
30s,20,43,0,5,68,0.01
20s,7,21,0,1,29,0.0
<20,4,2,0,0,6,0.0
UNKNOWN,0,0,0,1,1,0.0
