age_group,fatal-f,fatal-m,fatal-gd,fatal-u,fatal-total,fatal%
80s,1592,1555,0,19,3166,0.34
90+,1606,847,0,18,2471,0.27
70s,737,1159,0,6,1902,0.2
60s,359,710,0,7,1076,0.12
50s,158,298,0,3,459,0.05
40s,46,95,0,2,143,0.02
30s,15,40,0,4,59,0.01
20s,7,17,0,2,26,0.0
<20,2,2,0,0,4,0.0
UNKNOWN,0,0,0,1,1,0.0
